#########Z#
#         #
######### #
S     #   #
##### # ###
#     # # #
# ### # # #
# #   #   #
# ####### #
#         #
###########
